{
    "width": 11,
    "height": 11,
    "tiles": [
        1, 1, 1, 1, 1, 1, 1, 1, 1, 1, 1,
        1, 3, 3, 3, 3, 3, 3, 3, 3, 4, 1,
        1, 3, 1, 1, 3, 1, 3, 1, 1, 3, 1,
        1, 3, 1, 1, 3, 1, 3, 1, 1, 3, 1,
        1, 3, 3, 3, 3, 1, 3, 3, 3, 3, 1,
        1, 3, 1, 1, 1, 1, 1, 1, 1, 3, 1,
        1, 3, 3, 3, 3, 1, 3, 3, 3, 3, 1,
        1, 3, 1, 1, 3, 1, 3, 1, 1, 3, 1,
        1, 3, 1, 1, 3, 1, 3, 1, 1, 3, 1,
        1, 5, 3, 3, 3, 3, 3, 3, 3, 3, 1,
        1, 1, 1, 1, 1, 1, 1, 1, 1, 1, 1
    ]
}
