{
    "width": 5,
    "height": 5,
    "tiles": [
        1, 1, 1, 1, 1,
        1, 3, 1, 2, 1,
        1, 2, 2, 2, 1,
        1, 2, 1, 2, 1,
        1, 1, 1, 1, 1
    ]
}
